League,Goals For,Team,GF Home,GF Away,GF First Half,GF Second Half,GF First 15 mins,GF Last 10 mins,GF Home Matches Scored In,GF Away Matches Scored In,GF Pld,GF Per Match,Season,KEY
Premier League,83,Manchester City,44,39,37,46,10,17,17,18,38,2.18,2014/15,Premier League|Manchester City|2014/15
Premier League,73,Chelsea,36,37,37,36,15,8,19,16,38,1.92,2014/15,Premier League|Chelsea|2014/15
Premier League,71,Arsenal,41,30,36,35,9,15,16,17,38,1.87,2014/15,Premier League|Arsenal|2014/15
Premier League,62,Manchester United,41,21,33,29,8,9,17,13,38,1.63,2014/15,Premier League|Manchester United|2014/15
Premier League,58,Tottenham Hotspur,31,27,27,31,11,11,13,15,38,1.53,2014/15,Premier League|Tottenham Hotspur|2014/15
Premier League,54,Southampton,37,17,24,30,6,11,14,12,38,1.42,2014/15,Premier League|Southampton|2014/15
Premier League,52,Liverpool,30,22,21,31,8,9,16,14,38,1.37,2014/15,Premier League|Liverpool|2014/15
Premier League,48,Everton,27,21,24,24,7,8,13,13,38,1.26,2014/15,Premier League|Everton|2014/15
Premier League,48,Stoke City,32,16,30,18,8,9,16,13,38,1.26,2014/15,Premier League|Stoke City|2014/15
Premier League,47,Crystal Palace,21,26,17,30,2,8,14,11,38,1.24,2014/15,Premier League|Crystal Palace|2014/15
Premier League,46,Leicester City,28,18,21,25,6,9,13,11,38,1.21,2014/15,Premier League|Leicester City|2014/15
Premier League,46,Swansea City,27,19,19,27,6,9,16,14,38,1.21,2014/15,Premier League|Swansea City|2014/15
Premier League,44,West Ham United,25,19,19,25,5,3,16,11,38,1.16,2014/15,Premier League|West Ham United|2014/15
Premier League,42,Queens Park Rangers,23,19,17,25,2,8,13,13,38,1.11,2014/15,Premier League|Queens Park Rangers|2014/15
Premier League,40,Newcastle United,26,14,13,27,1,5,16,9,38,1.05,2014/15,Premier League|Newcastle United|2014/15
Premier League,38,West Bromwich Albion,24,14,16,22,7,3,14,11,38,1,2014/15,Premier League|West Bromwich Albion|2014/15
Premier League,33,Hull City,19,14,16,17,2,4,12,9,38,0.87,2014/15,Premier League|Hull City|2014/15
Premier League,31,Aston Villa,18,13,22,9,4,4,11,9,38,0.82,2014/15,Premier League|Aston Villa|2014/15
Premier League,31,Sunderland,16,15,17,14,5,6,11,10,38,0.82,2014/15,Premier League|Sunderland|2014/15
Premier League,28,Burnley,14,14,16,12,8,5,11,9,38,0.74,2014/15,Premier League|Burnley|2014/15
Bundesliga,80,Bayern Munich,46,34,35,45,9,14,15,14,34,2.35,2014/15,Bundesliga|Bayern Munich|2014/15
Bundesliga,72,VfL Wolfsburg,38,34,35,37,17,11,17,14,34,2.12,2014/15,Bundesliga|VfL Wolfsburg|2014/15
Bundesliga,62,Bayer Leverkusen,39,23,23,39,7,10,15,13,34,1.82,2014/15,Bundesliga|Bayer Leverkusen|2014/15
Bundesliga,56,Eintracht Frankfurt,36,20,24,32,6,8,14,12,34,1.65,2014/15,Bundesliga|Eintracht Frankfurt|2014/15
Bundesliga,53,"Borussia M'gladbach",32,21,26,27,10,12,16,11,34,1.56,2014/15,"Bundesliga|Borussia M'gladbach|2014/15"
Bundesliga,50,Werder Bremen,25,25,24,26,5,7,12,15,34,1.47,2014/15,Bundesliga|Werder Bremen|2014/15
Bundesliga,49,TSG 1899 Hoffenheim,31,18,27,22,6,10,15,11,34,1.44,2014/15,Bundesliga|TSG 1899 Hoffenheim|2014/15
Bundesliga,47,Borussia Dortmund,26,21,22,25,8,4,11,12,34,1.38,2014/15,Bundesliga|Borussia Dortmund|2014/15
Bundesliga,45,1. FSV Mainz 05,27,18,21,24,4,10,14,10,34,1.32,2014/15,Bundesliga|1. FSV Mainz 05|2014/15
Bundesliga,43,FC Augsburg,28,15,14,29,5,7,13,10,34,1.26,2014/15,Bundesliga|FC Augsburg|2014/15
Bundesliga,42,VfB Stuttgart,18,24,16,26,2,6,8,13,34,1.24,2014/15,Bundesliga|VfB Stuttgart|2014/15
Bundesliga,42,FC Schalke 04,26,16,20,22,8,6,14,9,34,1.24,2014/15,Bundesliga|FC Schalke 04|2014/15
Bundesliga,40,Hannover 96,21,19,16,24,5,7,16,10,34,1.18,2014/15,Bundesliga|Hannover 96|2014/15
Bundesliga,36,Hertha BSC,17,19,17,19,1,11,10,11,34,1.06,2014/15,Bundesliga|Hertha BSC|2014/15
Bundesliga,36,SC Freiburg,21,15,15,21,2,10,12,10,34,1.06,2014/15,Bundesliga|SC Freiburg|2014/15
Bundesliga,33,1. FC Koln,17,16,16,17,7,4,9,9,34,0.97,2014/15,Bundesliga|1. FC Koln|2014/15
Bundesliga,30,SC Paderborn 07,20,10,8,22,1,8,12,5,34,0.88,2014/15,Bundesliga|SC Paderborn 07|2014/15
Bundesliga,24,Hamburger SV,15,9,12,12,4,4,10,6,34,0.71,2014/15,Bundesliga|Hamburger SV|2014/15
La Liga,118,Real Madrid,65,53,55,63,11,24,19,17,38,3.11,2014/15,La Liga|Real Madrid|2014/15
La Liga,110,Barcelona,64,46,40,70,10,21,17,16,38,2.89,2014/15,La Liga|Barcelona|2014/15
La Liga,71,Sevilla,38,33,32,39,7,11,17,17,38,1.87,2014/15,La Liga|Sevilla|2014/15
La Liga,70,Valencia,42,28,34,36,10,10,16,16,38,1.84,2014/15,La Liga|Valencia|2014/15
La Liga,67,Atletico Madrid,42,25,40,27,15,9,16,14,38,1.76,2014/15,La Liga|Atletico Madrid|2014/15
La Liga,48,Villarreal,29,19,18,30,2,12,13,13,38,1.26,2014/15,La Liga|Villarreal|2014/15
La Liga,47,Espanyol,23,24,20,27,4,17,16,14,38,1.24,2014/15,La Liga|Espanyol|2014/15
La Liga,47,Celta Vigo,30,17,18,29,5,8,15,14,38,1.24,2014/15,La Liga|Celta Vigo|2014/15
La Liga,46,Rayo Vallecano,26,20,27,19,2,8,14,14,38,1.21,2014/15,La Liga|Rayo Vallecano|2014/15
La Liga,44,Real Sociedad,29,15,20,24,7,9,15,10,38,1.16,2014/15,La Liga|Real Sociedad|2014/15
La Liga,42,Athletic Bilbao,28,14,19,23,4,8,16,9,38,1.11,2014/15,La Liga|Athletic Bilbao|2014/15
La Liga,42,Malaga,26,16,14,28,3,8,16,12,38,1.11,2014/15,La Liga|Malaga|2014/15
La Liga,35,UD Almeria,20,15,19,16,5,3,13,10,38,0.92,2014/15,La Liga|UD Almeria|2014/15
La Liga,35,Elche CF,19,16,18,17,5,6,11,10,38,0.92,2014/15,La Liga|Elche CF|2014/15
La Liga,35,Deportivo La Coruna,22,13,14,21,3,7,13,10,38,0.92,2014/15,La Liga|Deportivo La Coruna|2014/15
La Liga,34,Levante,20,14,13,21,3,6,11,8,38,0.89,2014/15,La Liga|Levante|2014/15
La Liga,34,Eibar,20,14,20,14,5,4,11,10,38,0.89,2014/15,La Liga|Eibar|2014/15
La Liga,33,Getafe,16,17,14,19,1,10,12,11,38,0.87,2014/15,La Liga|Getafe|2014/15
La Liga,29,Granada CF,13,16,12,17,7,4,11,12,38,0.76,2014/15,La Liga|Granada CF|2014/15
La Liga,22,Cordoba,12,10,10,12,5,4,11,8,38,0.58,2014/15,La Liga|Cordoba|2014/15
French Ligue 1,83,Paris Saint-Germain,52,31,43,40,10,11,18,16,38,2.18,2014/15,French Ligue 1|Paris Saint-Germain|2014/15
French Ligue 1,76,Olympique Marseille,40,36,30,46,9,12,17,14,38,2,2014/15,French Ligue 1|Olympique Marseille|2014/15
French Ligue 1,72,Olympique Lyonnais,40,32,30,42,9,19,18,14,38,1.89,2014/15,French Ligue 1|Olympique Lyonnais|2014/15
French Ligue 1,54,Caen,26,28,24,30,9,13,13,14,38,1.42,2014/15,French Ligue 1|Caen|2014/15
French Ligue 1,51,AS Monaco,23,28,25,26,7,8,14,17,38,1.34,2014/15,French Ligue 1|AS Monaco|2014/15
French Ligue 1,50,AS Saint-Etienne,32,18,21,29,2,10,16,11,38,1.32,2014/15,French Ligue 1|AS Saint-Etienne|2014/15
French Ligue 1,47,Girondins De Bordeaux,31,16,19,28,3,7,18,12,38,1.24,2014/15,French Ligue 1|Girondins De Bordeaux|2014/15
French Ligue 1,47,Stade Reims,24,23,22,25,9,13,14,15,38,1.24,2014/15,French Ligue 1|Stade Reims|2014/15
French Ligue 1,46,Montpellier HSC,30,16,18,28,6,10,15,9,38,1.21,2014/15,French Ligue 1|Montpellier HSC|2014/15
French Ligue 1,44,Lorient,17,27,17,27,7,10,10,12,38,1.16,2014/15,French Ligue 1|Lorient|2014/15
French Ligue 1,44,OGC Nice,21,23,21,23,5,5,14,11,38,1.16,2014/15,French Ligue 1|OGC Nice|2014/15
French Ligue 1,43,Lille OSC,26,17,17,26,5,3,14,12,38,1.13,2014/15,French Ligue 1|Lille OSC|2014/15
French Ligue 1,43,Toulouse,28,15,22,21,4,9,17,10,38,1.13,2014/15,French Ligue 1|Toulouse|2014/15
French Ligue 1,41,Evian Thonon Gaillard,20,21,15,26,4,9,14,12,38,1.08,2014/15,French Ligue 1|Evian Thonon Gaillard|2014/15
French Ligue 1,41,En Avant Guingamp,23,18,18,23,5,5,12,12,38,1.08,2014/15,French Ligue 1|En Avant Guingamp|2014/15
French Ligue 1,37,SC Bastia,24,13,19,18,2,4,14,11,38,0.97,2014/15,French Ligue 1|SC Bastia|2014/15
French Ligue 1,35,Stade Rennes,22,13,16,19,6,9,13,10,38,0.92,2014/15,French Ligue 1|Stade Rennes|2014/15
French Ligue 1,33,RC Lens,15,18,14,19,5,8,10,13,38,0.87,2014/15,French Ligue 1|RC Lens|2014/15
French Ligue 1,31,FC Metz,26,5,11,20,4,6,12,5,38,0.82,2014/15,French Ligue 1|FC Metz|2014/15
French Ligue 1,29,FC Nantes,17,12,16,13,7,2,14,9,38,0.76,2014/15,French Ligue 1|FC Nantes|2014/15
Eredivisie,92,PSV Eindhoven,50,42,41,51,11,16,17,16,34,2.71,2014/15,Eredivisie|PSV Eindhoven|2014/15
Eredivisie,69,AFC Ajax,37,32,30,39,11,15,13,15,34,2.03,2014/15,Eredivisie|AFC Ajax|2014/15
Eredivisie,66,Vitesse Arnhem,36,30,37,29,9,11,15,14,34,1.94,2014/15,Eredivisie|Vitesse Arnhem|2014/15
Eredivisie,62,AZ Alkmaar,30,32,26,36,10,11,15,14,34,1.82,2014/15,Eredivisie|AZ Alkmaar|2014/15
Eredivisie,60,FC Utrecht,32,28,23,37,6,18,14,14,34,1.76,2014/15,Eredivisie|FC Utrecht|2014/15
Eredivisie,59,PEC Zwolle,40,19,21,38,5,13,16,11,34,1.74,2014/15,Eredivisie|PEC Zwolle|2014/15
Eredivisie,56,FC Twente,26,30,24,32,8,12,14,14,34,1.65,2014/15,Eredivisie|FC Twente|2014/15
Eredivisie,56,Feyenoord,31,25,26,30,6,10,15,11,34,1.65,2014/15,Eredivisie|Feyenoord|2014/15
Eredivisie,53,SC Heerenveen,33,20,25,28,10,10,14,14,34,1.56,2014/15,Eredivisie|SC Heerenveen|2014/15
Eredivisie,49,FC Groningen,26,23,25,24,10,9,16,11,34,1.44,2014/15,Eredivisie|FC Groningen|2014/15
Eredivisie,47,SBV Excelsior,26,21,19,28,5,9,14,12,34,1.38,2014/15,Eredivisie|SBV Excelsior|2014/15
Eredivisie,47,Heracles Almelo,23,24,19,28,7,9,13,12,34,1.38,2014/15,Eredivisie|Heracles Almelo|2014/15
Eredivisie,46,SC Cambuur,25,21,16,30,7,14,13,14,34,1.35,2014/15,Eredivisie|SC Cambuur|2014/15
Eredivisie,46,Willem II Tilburg,25,21,18,28,4,8,16,10,34,1.35,2014/15,Eredivisie|Willem II Tilburg|2014/15
Eredivisie,44,ADO Den Haag,30,14,15,29,4,12,15,10,34,1.29,2014/15,Eredivisie|ADO Den Haag|2014/15
Eredivisie,36,NAC Breda,19,17,16,20,2,8,11,11,34,1.06,2014/15,Eredivisie|NAC Breda|2014/15
Eredivisie,29,Go Ahead Eagles,14,15,15,14,4,4,10,10,34,0.85,2014/15,Eredivisie|Go Ahead Eagles|2014/15
Eredivisie,24,FC Dordrecht,15,9,6,18,2,8,11,7,34,0.71,2014/15,Eredivisie|FC Dordrecht|2014/15
Serie A,72,Juventus,45,27,38,34,11,10,19,15,38,1.89,2014/15,Serie A|Juventus|2014/15
Serie A,71,SS Lazio,40,31,35,36,10,14,15,16,38,1.87,2014/15,Serie A|SS Lazio|2014/15
Serie A,70,Napoli,46,24,26,44,7,12,18,14,38,1.84,2014/15,Serie A|Napoli|2014/15
Serie A,61,Genoa,33,28,29,32,7,12,16,16,38,1.61,2014/15,Serie A|Genoa|2014/15
Serie A,61,Fiorentina,30,31,23,38,4,9,13,15,38,1.61,2014/15,Serie A|Fiorentina|2014/15
Serie A,59,Internazionale,33,26,24,35,6,12,15,14,38,1.55,2014/15,Serie A|Internazionale|2014/15
Serie A,55,AC Milan,29,26,27,28,6,4,16,14,38,1.45,2014/15,Serie A|AC Milan|2014/15
Serie A,54,AS Roma,31,23,27,27,7,10,16,16,38,1.42,2014/15,Serie A|AS Roma|2014/15
Serie A,53,Palermo,30,23,35,18,13,6,16,12,38,1.39,2014/15,Serie A|Palermo|2014/15
Serie A,49,Hellas Verona,27,22,21,28,7,9,16,14,38,1.29,2014/15,Serie A|Hellas Verona|2014/15
Serie A,49,Sassuolo,25,24,23,26,6,4,13,14,38,1.29,2014/15,Serie A|Sassuolo|2014/15
Serie A,48,Cagliari,24,24,26,22,7,9,15,12,38,1.26,2014/15,Serie A|Cagliari|2014/15
Serie A,48,Torino,25,23,21,27,5,6,13,14,38,1.26,2014/15,Serie A|Torino|2014/15
Serie A,47,Sampdoria,22,25,16,31,4,8,15,15,38,1.24,2014/15,Serie A|Sampdoria|2014/15
Serie A,46,Empoli,26,20,20,26,5,3,12,14,38,1.21,2014/15,Serie A|Empoli|2014/15
Serie A,43,Udinese,26,17,20,23,4,5,15,12,38,1.13,2014/15,Serie A|Udinese|2014/15
Serie A,38,Atalanta,22,16,18,20,4,5,15,10,38,1,2014/15,Serie A|Atalanta|2014/15
Serie A,36,AC Cesena,19,17,15,21,3,7,13,12,38,0.95,2014/15,Serie A|AC Cesena|2014/15
Serie A,33,Parma,19,14,16,17,3,2,13,9,38,0.87,2014/15,Serie A|Parma|2014/15
Serie A,28,Chievo,16,12,12,16,6,7,12,10,38,0.74,2014/15,Serie A|Chievo|2014/15
Scottish Premiership,84,Celtic,50,34,34,50,11,13,16,17,38,2.21,2014/15,Scottish Premiership|Celtic|2014/15
Scottish Premiership,58,Dundee United,32,26,28,30,9,8,15,13,38,1.53,2014/15,Scottish Premiership|Dundee United|2014/15
Scottish Premiership,57,Aberdeen,32,25,27,30,8,7,15,15,38,1.5,2014/15,Scottish Premiership|Aberdeen|2014/15
Scottish Premiership,52,Inverness Cali,29,23,21,31,7,6,16,14,38,1.37,2014/15,Scottish Premiership|Inverness Cali|2014/15
Scottish Premiership,50,Hamilton Academical,30,20,23,27,7,10,13,11,38,1.32,2014/15,Scottish Premiership|Hamilton Academical|2014/15
Scottish Premiership,48,Partick Thistle,32,16,20,28,5,8,15,8,38,1.26,2014/15,Scottish Premiership|Partick Thistle|2014/15
Scottish Premiership,46,Ross County,21,25,17,29,3,8,15,14,38,1.21,2014/15,Scottish Premiership|Ross County|2014/15
Scottish Premiership,46,Dundee,25,21,20,26,7,9,18,13,38,1.21,2014/15,Scottish Premiership|Dundee|2014/15
Scottish Premiership,44,Kilmarnock,23,21,18,26,4,6,14,13,38,1.16,2014/15,Scottish Premiership|Kilmarnock|2014/15
Scottish Premiership,38,Motherwell,23,15,14,24,3,4,12,12,38,1,2014/15,Scottish Premiership|Motherwell|2014/15
Scottish Premiership,34,St Johnstone,19,15,12,22,5,6,14,12,38,0.89,2014/15,Scottish Premiership|St Johnstone|2014/15
Scottish Premiership,30,St Mirren,14,16,11,19,3,8,9,9,38,0.79,2014/15,Scottish Premiership|St Mirren|2014/15
